hkg.contribute.live-video.net	AS: Hong Kong	Online
maa01.contribute.live-video.net	AS: India, Chennai	Online
bom01.contribute.live-video.net	AS: India, Mumbai	Online
tyo01.contribute.live-video.net	AS: Japan, Tokyo (1)	Online
tyo03.contribute.live-video.net	AS: Japan, Tokyo (3)	Online
sin.contribute.live-video.net	AS: Singapore	Online
sel01.contribute.live-video.net	AS: South Korea, Seoul (1)	Online
sel03.contribute.live-video.net	AS: South Korea, Seoul (3)	Online
tpe01.contribute.live-video.net	AS: Taiwan, Taipei (1)	Online
tpe03.contribute.live-video.net	AS: Taiwan, Taipei (3)	Online
bkk.contribute.live-video.net	AS: Thailand, Bangkok	Online
syd01.contribute.live-video.net	AU: Sydney (1)	Online
syd02.contribute.live-video.net	AU: Sydney (2)	Online
vie.contribute.live-video.net	Europe: Austria, Vienna	Online
prg.contribute.live-video.net	Europe: Czech Republic, Prague	Online
cph.contribute.live-video.net	Europe: Denmark, Copenhagen	Online
hel.contribute.live-video.net	Europe: Finland, Helsinki	Online
mrs.contribute.live-video.net	Europe: France, Marseille	Online
cdg.contribute.live-video.net	Europe: France, Paris	Online
ber.contribute.live-video.net	Europe: Germany, Berlin	Online
fra02.contribute.live-video.net	Europe: Germany, Frankfurt (2)	Online
fra05.contribute.live-video.net	Europe: Germany, Frankfurt (5)	Online
mil.contribute.live-video.net	Europe: Italy, Milan	Online
ams02.contribute.live-video.net	Europe: Netherlands, Amsterdam (2)	Online
ams03.contribute.live-video.net	Europe: Netherlands, Amsterdam (3)	Online
osl.contribute.live-video.net	Europe: Norway, Oslo	Online
waw.contribute.live-video.net	Europe: Poland, Warsaw	Online
mad.contribute.live-video.net	Europe: Spain, Madrid	Online
arn.contribute.live-video.net	Europe: Sweden, Stockholm	Online
lhr03.contribute.live-video.net	Europe: UK, London (3)	Online
lhr04.contribute.live-video.net	Europe: UK, London (4)	Online
ymq.contribute.live-video.net	NA: Canada, Quebec	Online
yto.contribute.live-video.net	NA: Canada, Toronto	Online
qro.contribute.live-video.net	NA: Mexico, Queretaro	Online
rio.contribute.live-video.net	South America: Brazil, Rio de Janeiro	Online
sao.contribute.live-video.net	South America: Brazil, Sao Paulo	Online
dfw.contribute.live-video.net	US Central: Dallas, TX	Online
den.contribute.live-video.net	US Central: Denver, CO	Online
hou.contribute.live-video.net	US Central: Houston, TX	Online
iad03.contribute.live-video.net	US East: Ashburn, VA (3)	Online
iad05.contribute.live-video.net	US East: Ashburn, VA (5)	Online
atl.contribute.live-video.net	US East: Atlanta, GA	Online
ord02.contribute.live-video.net	US East: Chicago, IL (2)	Online
ord03.contribute.live-video.net	US East: Chicago, IL (3)	Online
mia.contribute.live-video.net	US East: Miami, FL	Online
jfk.contribute.live-video.net	US East: New York, NY	Online
lax.contribute.live-video.net	US West: Los Angeles, CA	Online
phx.contribute.live-video.net	US West: Phoenix, AZ	Online
pdx.contribute.live-video.net	US West: Portland, OR	Online
slc.contribute.live-video.net	US West: Salt Lake City, UT	Online
sfo.contribute.live-video.net	US West: San Francisco, CA	Online
sjc02.contribute.live-video.net	US West: San Jose, CA (2)	Online
sjc05.contribute.live-video.net	US West: San Jose, CA (5)	Online
sea.contribute.live-video.net	US West: Seattle, WA	Online
